w,w,w,w,w,w,w,w,w
w,.,.,.,.,.,.,g,w
w,.,w,.,w,w,w,.,w
w,.,w,.,.,.,w,.,w
w,.,w,.,.,w,w,.,w
w,.,w,.,.,.,w,.,w
w,.,w,.,w,w,w,.,w
w,.,w,.,.,.,.,.,w
w,.,w,w,w,w,w,.,w
w,c,.,.,.,.,.,.,w
w,w,w,w,w,w,w,w,w
